有瀬かぐや	 아리세 카구야#N	1	VHn
有瀬あてな	 아리세 아테나#N	1	VHn
有瀬露伴	 아리세 로한#N	1	VHn
有瀬大介	 아리세 다이스케#N	1	VHn
有瀬幌子	 아리세 호로코#N	1	VHn
石川弥栄	 이시카와 야에#N	1	VHn
石川蜜子	 이시카와 미츠코#N	1	VHn
石川五右衛門	 이시카와 고에몬#N	1	VHn
本郷虹夢	 혼고 니지무#N	1	VHn
根津御影	 네즈 미카게#N	1	VHn
根津美春	 네즈 미하루#N	1	VHn
根津与吉	 네즈 요키치#N	1	VHn
根津たけし	 네즈 타케시#N	1	VHn
根津まつり	 네즈 마츠리#N	1	VHn
根津プラム	 네즈 프람#N	1	VHn
不破霊元	 후와 레이겐#N	1	VHn
不破沙雪	 후와 사유키#N	1	VHn
不破沙取	 후와 사토루#N	1	VHn
不破幌子	 후와 호로코#N	1	VHn
南句征丸	 난쿠 세이마루#N	1	VHn
小林つばめ	 코바야시 츠바메#N	1	VHn
明智小十郎	 아케치 코쥬로#N	1	VHn
富士良美	 후지 요시미#N	1	VHn
黒鳥引太郎	 쿠로토리 히키타로#N	1	VHn
鳴沢恭弥	 나루사와 쿄야#N	1	VHn
怪盗アルテ	 괴도 아테나#N	1	VHn
怪盗ミッドナイト	 괴도 미드나이트#N	1	VHn
怪盗ミネルバ	 괴도 미네르바#N	1	VHn
ウィルクラーク	 윌 클라크#N	1	VHn

//シャルロットディカーブホーンイェーズ	 샤를로트 디 커브혼 예즈#N	1	VHn
//カリストーミドヴェーチ	 칼리스토 미드베치#N	1	VHn

有瀬さん	 아리세씨#N	1	VHn
石川さん	 이시카와씨#N	1	VHn
本郷さん	 혼고씨#N	1	VHn
根津さん	 네즈씨#N	1	VHn
不破さん	 후와씨#N	1	VHn
南句さん	 난쿠씨#N	1	VHn
小林さん	 코바야시씨#N	1	VHn
明智さん	 아케치씨#N	1	VHn
富士さん	 후지씨#N	1	VHn
黒鳥さん	 쿠로토리씨#N	1	VHn
鳴沢さん	 나루사와씨#N	1	VHn
怪盗さん	 괴도씨#N	1	VHn
ウィルさん	 윌씨#N	1	VHn
シャルロットさん	 샤를로트씨#N	1	VHn
カリストーさん	 칼리스토씨#N	1	VHn
カリスさん	 카리스씨#N	1	VHn
ディさん	 디씨#N	1	VHn
カーブホーンさん	 커브혼씨#N	1	VHn
かぐやさん	 카구야씨#N	1	VHn
あてなさん	 아테나씨#N	1	VHn
露伴さん	 로한씨#N	1	VHn
大介さん	 다이스케씨#N	1	VHn
幌子さん	 호로코씨#N	1	VHn
弥栄さん	 야에씨#N	1	VHn
蜜子さん	 미츠코씨#N	1	VHn
五右衛門さん	 고에몬씨#N	1	VHn
虹夢さん	 니지무씨#N	1	VHn
御影さん	 미카게씨#N	1	VHn
美春さん	 미하루씨#N	1	VHn
与吉さん	 요키치씨#N	1	VHn
たけしさん	 타케시씨#N	1	VHn
まつりさん	 마츠리씨#N	1	VHn
プラムさん	 프람씨#N	1	VHn
霊元さん	 레이겐씨#N	1	VHn
沙雪さん	 사유키씨#N	1	VHn
沙取さん	 사토루씨#N	1	VHn
征丸さん	 세이마루씨#N	1	VHn
つばめさん	 츠바메씨#N	1	VHn
小十郎さん	 코쥬로씨#N	1	VHn
良美さん	 요시미씨#N	1	VHn
引太郎さん	 히키타로씨#N	1	VHn
恭弥さん	 쿄야씨#N	1	VHn
アルテさん	 아테나씨#N	1	VHn
ミッドナイトさん	 미드나이트씨#N	1	VHn
ミネルバさん	 미네르바씨#N	1	VHn
クラークさん	 클라크씨#N	1	VHn
ミドヴェーチさん	 미드베치씨#N	1	VHn
イェーズさん	 예즈씨#N	1	VHn

有瀬ちゃん	 아리세짱#N	1	VHn
石川ちゃん	 이시카와짱#N	1	VHn
本郷ちゃん	 혼고짱#N	1	VHn
根津ちゃん	 네즈짱#N	1	VHn
不破ちゃん	 후와짱#N	1	VHn
南句ちゃん	 난쿠짱#N	1	VHn
小林ちゃん	 코바야시짱#N	1	VHn
明智ちゃん	 아케치짱#N	1	VHn
富士ちゃん	 후지짱#N	1	VHn
黒鳥ちゃん	 쿠로토리짱#N	1	VHn
鳴沢ちゃん	 나루사와짱#N	1	VHn
怪盗ちゃん	 괴도짱#N	1	VHn
ウィルちゃん	 윌짱#N	1	VHn
シャルロットちゃん	 샤를로트짱#N	1	VHn
カリストーちゃん	 칼리스토짱#N	1	VHn
カリスちゃん	 카리스짱#N	1	VHn
ディちゃん	 디짱#N	1	VHn
カーブホーンちゃん	 커브혼짱#N	1	VHn
かぐやちゃん	 카구야짱#N	1	VHn
あてなちゃん	 아테나짱#N	1	VHn
露伴ちゃん	 로한짱#N	1	VHn
大介ちゃん	 다이스케짱#N	1	VHn
幌子ちゃん	 호로코짱#N	1	VHn
弥栄ちゃん	 야에짱#N	1	VHn
蜜子ちゃん	 미츠코짱#N	1	VHn
五右衛門ちゃん	 고에몬짱#N	1	VHn
虹夢ちゃん	 니지무짱#N	1	VHn
御影ちゃん	 미카게짱#N	1	VHn
美春ちゃん	 미하루짱#N	1	VHn
与吉ちゃん	 요키치짱#N	1	VHn
たけしちゃん	 타케시짱#N	1	VHn
まつりちゃん	 마츠리짱#N	1	VHn
プラムちゃん	 프람짱#N	1	VHn
霊元ちゃん	 레이겐짱#N	1	VHn
沙雪ちゃん	 사유키짱#N	1	VHn
沙取ちゃん	 사토루짱#N	1	VHn
征丸ちゃん	 세이마루짱#N	1	VHn
つばめちゃん	 츠바메짱#N	1	VHn
小十郎ちゃん	 코쥬로짱#N	1	VHn
良美ちゃん	 요시미짱#N	1	VHn
引太郎ちゃん	 히키타로짱#N	1	VHn
恭弥ちゃん	 쿄야짱#N	1	VHn
アルテちゃん	 아테나짱#N	1	VHn
ミッドナイトちゃん	 미드나이트짱#N	1	VHn
ミネルバちゃん	 미네르바짱#N	1	VHn
クラークちゃん	 클라크짱#N	1	VHn
ミドヴェーチちゃん	 미드베치짱#N	1	VHn
イェーズちゃん	 예즈짱#N	1	VHn

有瀬くぅん	 아리세군~#N	1	VHn
石川くぅん	 이시카와군~#N	1	VHn
本郷くぅん	 혼고군~#N	1	VHn
根津くぅん	 네즈군~#N	1	VHn
不破くぅん	 후와군~#N	1	VHn
南句くぅん	 난쿠군~#N	1	VHn
小林くぅん	 코바야시군~#N	1	VHn
明智くぅん	 아케치군~#N	1	VHn
富士くぅん	 후지군~#N	1	VHn
黒鳥くぅん	 쿠로토리군~#N	1	VHn
鳴沢くぅん	 나루사와군~#N	1	VHn
怪盗くぅん	 괴도군~#N	1	VHn
ウィルくぅん	 윌군~#N	1	VHn
シャルロットくぅん	 샤를로트군~#N	1	VHn
カリストーくぅん	 칼리스토군~#N	1	VHn
カリスくぅん	 카리스군~#N	1	VHn
ディくぅん	 디군~#N	1	VHn
カーブホーンくぅん	 커브혼군~#N	1	VHn
かぐやくぅん	 카구야군~#N	1	VHn
あてなくぅん	 아테나군~#N	1	VHn
露伴くぅん	 로한군~#N	1	VHn
大介くぅん	 다이스케군~#N	1	VHn
幌子くぅん	 호로코군~#N	1	VHn
弥栄くぅん	 야에군~#N	1	VHn
蜜子くぅん	 미츠코군~#N	1	VHn
五右衛門くぅん	 고에몬군~#N	1	VHn
虹夢くぅん	 니지무군~#N	1	VHn
御影くぅん	 미카게군~#N	1	VHn
美春くぅん	 미하루군~#N	1	VHn
与吉くぅん	 요키치군~#N	1	VHn
たけしくぅん	 타케시군~#N	1	VHn
まつりくぅん	 마츠리군~#N	1	VHn
プラムくぅん	 프람군~#N	1	VHn
霊元くぅん	 레이겐군~#N	1	VHn
沙雪くぅん	 사유키군~#N	1	VHn
沙取くぅん	 사토루군~#N	1	VHn
征丸くぅん	 세이마루군~#N	1	VHn
つばめくぅん	 츠바메군~#N	1	VHn
小十郎くぅん	 코쥬로군~#N	1	VHn
良美くぅん	 요시미군~#N	1	VHn
引太郎くぅん	 히키타로군~#N	1	VHn
恭弥くぅん	 쿄야군~#N	1	VHn
アルテくぅん	 아테나군~#N	1	VHn
ミッドナイトくぅん	 미드나이트군~#N	1	VHn
ミネルバくぅん	 미네르바군~#N	1	VHn
クラークくぅん	 클라크군~#N	1	VHn
ミドヴェーチくぅん	 미드베치군~#N	1	VHn
イェーズくぅん	 예즈군~#N	1	VHn

有瀬ちん	 아리세찡#N	1	VHn
石川ちん	 이시카와찡#N	1	VHn
本郷ちん	 혼고찡#N	1	VHn
根津ちん	 네즈찡#N	1	VHn
不破ちん	 후와찡#N	1	VHn
南句ちん	 난쿠찡#N	1	VHn
小林ちん	 코바야시찡#N	1	VHn
明智ちん	 아케치찡#N	1	VHn
富士ちん	 후지찡#N	1	VHn
黒鳥ちん	 쿠로토리찡#N	1	VHn
鳴沢ちん	 나루사와찡#N	1	VHn
怪盗ちん	 괴도찡#N	1	VHn
ウィルちん	 윌찡#N	1	VHn
シャルロットちん	 샤를로트찡#N	1	VHn
カリストーちん	 칼리스토찡#N	1	VHn
カリスちん	 카리스찡#N	1	VHn
ディちん	 디찡#N	1	VHn
カーブホーンちん	 커브혼찡#N	1	VHn
かぐやちん	 카구야찡#N	1	VHn
あてなちん	 아테나찡#N	1	VHn
露伴ちん	 로한찡#N	1	VHn
大介ちん	 다이스케찡#N	1	VHn
幌子ちん	 호로코찡#N	1	VHn
弥栄ちん	 야에찡#N	1	VHn
蜜子ちん	 미츠코찡#N	1	VHn
五右衛門ちん	 고에몬찡#N	1	VHn
虹夢ちん	 니지무찡#N	1	VHn
御影ちん	 미카게찡#N	1	VHn
美春ちん	 미하루찡#N	1	VHn
与吉ちん	 요키치찡#N	1	VHn
たけしちん	 타케시찡#N	1	VHn
まつりちん	 마츠리찡#N	1	VHn
プラムちん	 프람찡#N	1	VHn
霊元ちん	 레이겐찡#N	1	VHn
沙雪ちん	 사유키찡#N	1	VHn
沙取ちん	 사토루찡#N	1	VHn
征丸ちん	 세이마루찡#N	1	VHn
つばめちん	 츠바메찡#N	1	VHn
小十郎ちん	 코쥬로찡#N	1	VHn
良美ちん	 요시미찡#N	1	VHn
引太郎ちん	 히키타로찡#N	1	VHn
恭弥ちん	 쿄야찡#N	1	VHn
アルテちん	 아테나찡#N	1	VHn
ミッドナイトちん	 미드나이트찡#N	1	VHn
ミネルバちん	 미네르바찡#N	1	VHn
クラークちん	 클라크찡#N	1	VHn
ミドヴェーチちん	 미드베치찡#N	1	VHn
イェーズちん	 예즈찡#N	1	VHn

有瀬くん	 아리세군#N	1	VHn
石川くん	 이시카와군#N	1	VHn
本郷くん	 혼고군#N	1	VHn
根津くん	 네즈군#N	1	VHn
不破くん	 후와군#N	1	VHn
南句くん	 난쿠군#N	1	VHn
小林くん	 코바야시군#N	1	VHn
明智くん	 아케치군#N	1	VHn
富士くん	 후지군#N	1	VHn
黒鳥くん	 쿠로토리군#N	1	VHn
鳴沢くん	 나루사와군#N	1	VHn
怪盗くん	 괴도군#N	1	VHn
ウィルくん	 윌군#N	1	VHn
シャルロットくん	 샤를로트군#N	1	VHn
カリストーくん	 칼리스토군#N	1	VHn
カリスくん	 카리스군#N	1	VHn
ディくん	 디군#N	1	VHn
カーブホーンくん	 커브혼군#N	1	VHn
かぐやくん	 카구야군#N	1	VHn
あてなくん	 아테나군#N	1	VHn
露伴くん	 로한군#N	1	VHn
大介くん	 다이스케군#N	1	VHn
幌子くん	 호로코군#N	1	VHn
弥栄くん	 야에군#N	1	VHn
蜜子くん	 미츠코군#N	1	VHn
五右衛門くん	 고에몬군#N	1	VHn
虹夢くん	 니지무군#N	1	VHn
御影くん	 미카게군#N	1	VHn
美春くん	 미하루군#N	1	VHn
与吉くん	 요키치군#N	1	VHn
たけしくん	 타케시군#N	1	VHn
まつりくん	 마츠리군#N	1	VHn
プラムくん	 프람군#N	1	VHn
霊元くん	 레이겐군#N	1	VHn
沙雪くん	 사유키군#N	1	VHn
沙取くん	 사토루군#N	1	VHn
征丸くん	 세이마루군#N	1	VHn
つばめくん	 츠바메군#N	1	VHn
小十郎くん	 코쥬로군#N	1	VHn
良美くん	 요시미군#N	1	VHn
引太郎くん	 히키타로군#N	1	VHn
恭弥くん	 쿄야군#N	1	VHn
アルテくん	 아테나군#N	1	VHn
ミッドナイトくん	 미드나이트군#N	1	VHn
ミネルバくん	 미네르바군#N	1	VHn
クラークくん	 클라크군#N	1	VHn
ミドヴェーチくん	 미드베치군#N	1	VHn
イェーズくん	 예즈군#N	1	VHn

有瀬たん	 아리세땅#N	1	VHn
石川たん	 이시카와땅#N	1	VHn
本郷たん	 혼고땅#N	1	VHn
根津たん	 네즈땅#N	1	VHn
不破たん	 후와땅#N	1	VHn
南句たん	 난쿠땅#N	1	VHn
小林たん	 코바야시땅#N	1	VHn
明智たん	 아케치땅#N	1	VHn
富士たん	 후지땅#N	1	VHn
黒鳥たん	 쿠로토리땅#N	1	VHn
鳴沢たん	 나루사와땅#N	1	VHn
怪盗たん	 괴도땅#N	1	VHn
ウィルたん	 윌땅#N	1	VHn
シャルロットたん	 샤를로트땅#N	1	VHn
カリストーたん	 칼리스토땅#N	1	VHn
カリスたん	 카리스땅#N	1	VHn
ディたん	 디땅#N	1	VHn
カーブホーンたん	 커브혼땅#N	1	VHn
かぐやたん	 카구야땅#N	1	VHn
あてなたん	 아테나땅#N	1	VHn
露伴たん	 로한땅#N	1	VHn
大介たん	 다이스케땅#N	1	VHn
幌子たん	 호로코땅#N	1	VHn
弥栄たん	 야에땅#N	1	VHn
蜜子たん	 미츠코땅#N	1	VHn
五右衛門たん	 고에몬땅#N	1	VHn
虹夢たん	 니지무땅#N	1	VHn
御影たん	 미카게땅#N	1	VHn
美春たん	 미하루땅#N	1	VHn
与吉たん	 요키치땅#N	1	VHn
たけしたん	 타케시땅#N	1	VHn
まつりたん	 마츠리땅#N	1	VHn
プラムたん	 프람땅#N	1	VHn
霊元たん	 레이겐땅#N	1	VHn
沙雪たん	 사유키땅#N	1	VHn
沙取たん	 사토루땅#N	1	VHn
征丸たん	 세이마루땅#N	1	VHn
つばめたん	 츠바메땅#N	1	VHn
小十郎たん	 코쥬로땅#N	1	VHn
良美たん	 요시미땅#N	1	VHn
引太郎たん	 히키타로땅#N	1	VHn
恭弥たん	 쿄야땅#N	1	VHn
アルテたん	 아테나땅#N	1	VHn
ミッドナイトたん	 미드나이트땅#N	1	VHn
ミネルバたん	 미네르바땅#N	1	VHn
クラークたん	 클라크땅#N	1	VHn
ミドヴェーチたん	 미드베치땅#N	1	VHn
イェーズたん	 예즈땅#N	1	VHn

有瀬っち	 아리세치#N	1	VHn
石川っち	 이시카와치#N	1	VHn
本郷っち	 혼고치#N	1	VHn
根津っち	 네즈치#N	1	VHn
不破っち	 후와치#N	1	VHn
南句っち	 난쿠치#N	1	VHn
小林っち	 코바야시치#N	1	VHn
明智っち	 아케치치#N	1	VHn
富士っち	 후지치#N	1	VHn
黒鳥っち	 쿠로토리치#N	1	VHn
鳴沢っち	 나루사와치#N	1	VHn
怪盗っち	 괴도치#N	1	VHn
ウィルっち	 윌치#N	1	VHn
シャルロットっち	 샤를로트치#N	1	VHn
カリストーっち	 칼리스토치#N	1	VHn
カリスっち	 카리스치#N	1	VHn
ディっち	 디치#N	1	VHn
カーブホーンっち	 커브혼치#N	1	VHn
かぐやっち	 카구야치#N	1	VHn
あてなっち	 아테나치#N	1	VHn
露伴っち	 로한치#N	1	VHn
大介っち	 다이스케치#N	1	VHn
幌子っち	 호로코치#N	1	VHn
弥栄っち	 야에치#N	1	VHn
蜜子っち	 미츠코치#N	1	VHn
五右衛門っち	 고에몬치#N	1	VHn
虹夢っち	 니지무치#N	1	VHn
御影っち	 미카게치#N	1	VHn
美春っち	 미하루치#N	1	VHn
与吉っち	 요키치치#N	1	VHn
たけしっち	 타케시치#N	1	VHn
まつりっち	 마츠리치#N	1	VHn
プラムっち	 프람치#N	1	VHn
霊元っち	 레이겐치#N	1	VHn
沙雪っち	 사유키치#N	1	VHn
沙取っち	 사토루치#N	1	VHn
征丸っち	 세이마루치#N	1	VHn
つばめっち	 츠바메치#N	1	VHn
小十郎っち	 코쥬로치#N	1	VHn
良美っち	 요시미치#N	1	VHn
引太郎っち	 히키타로치#N	1	VHn
恭弥っち	 쿄야치#N	1	VHn
アルテっち	 아테나치#N	1	VHn
ミッドナイトっち	 미드나이트치#N	1	VHn
ミネルバっち	 미네르바치#N	1	VHn
クラークっち	 클라크치#N	1	VHn
ミドヴェーチっち	 미드베치치#N	1	VHn
イェーズっち	 예즈치#N	1	VHn

有瀬手作り	 아리세 수제#N	1	VHn
石川手作り	 이시카와 수제#N	1	VHn
本郷手作り	 혼고 수제#N	1	VHn
根津手作り	 네즈 수제#N	1	VHn
不破手作り	 후와 수제#N	1	VHn
南句手作り	 난쿠 수제#N	1	VHn
小林手作り	 코바야시 수제#N	1	VHn
明智手作り	 아케치 수제#N	1	VHn
富士手作り	 후지 수제#N	1	VHn
黒鳥手作り	 쿠로토리 수제#N	1	VHn
鳴沢手作り	 나루사와 수제#N	1	VHn
怪盗手作り	 괴도 수제#N	1	VHn
ウィル手作り	 윌 수제#N	1	VHn
シャルロット手作り	 샤를로트 수제#N	1	VHn
カリストー手作り	 칼리스토 수제#N	1	VHn
カリス手作り	 카리스 수제#N	1	VHn
ディ手作り	 디 수제#N	1	VHn
カーブホーン手作り	 커브혼 수제#N	1	VHn
かぐや手作り	 카구야 수제#N	1	VHn
あてな手作り	 아테나 수제#N	1	VHn
露伴手作り	 로한 수제#N	1	VHn
大介手作り	 다이스케 수제#N	1	VHn
幌子手作り	 호로코 수제#N	1	VHn
弥栄手作り	 야에 수제#N	1	VHn
蜜子手作り	 미츠코 수제#N	1	VHn
五右衛門手作り	 고에몬 수제#N	1	VHn
虹夢手作り	 니지무 수제#N	1	VHn
御影手作り	 미카게 수제#N	1	VHn
美春手作り	 미하루 수제#N	1	VHn
与吉手作り	 요키치 수제#N	1	VHn
たけし手作り	 타케시 수제#N	1	VHn
まつり手作り	 마츠리 수제#N	1	VHn
プラム手作り	 프람 수제#N	1	VHn
霊元手作り	 레이겐 수제#N	1	VHn
沙雪手作り	 사유키 수제#N	1	VHn
沙取手作り	 사토루 수제#N	1	VHn
征丸手作り	 세이마루 수제#N	1	VHn
つばめ手作り	 츠바메 수제#N	1	VHn
小十郎手作り	 코쥬로 수제#N	1	VHn
良美手作り	 요시미 수제#N	1	VHn
引太郎手作り	 히키타로 수제#N	1	VHn
恭弥手作り	 쿄야 수제#N	1	VHn
アルテ手作り	 아테나 수제#N	1	VHn
ミッドナイト手作り	 미드나이트 수제#N	1	VHn
ミネルバ手作り	 미네르바 수제#N	1	VHn
クラーク手作り	 클라크 수제#N	1	VHn
ミドヴェーチ手作り	 미드베치 수제#N	1	VHn
イェーズ手作り	 예즈 수제#N	1	VHn

有瀬先生	 아리세 선생님#N	1	VHn
石川先生	 이시카와 선생님#N	1	VHn
本郷先生	 혼고 선생님#N	1	VHn
根津先生	 네즈 선생님#N	1	VHn
不破先生	 후와 선생님#N	1	VHn
南句先生	 난쿠 선생님#N	1	VHn
小林先生	 코바야시 선생님#N	1	VHn
明智先生	 아케치 선생님#N	1	VHn
富士先生	 후지 선생님#N	1	VHn
黒鳥先生	 쿠로토리 선생님#N	1	VHn
鳴沢先生	 나루사와 선생님#N	1	VHn
怪盗先生	 괴도 선생님#N	1	VHn
ウィル先生	 윌 선생님#N	1	VHn
シャルロット先生	 샤를로트 선생님#N	1	VHn
カリストー先生	 칼리스토 선생님#N	1	VHn
カリス先生	 카리스 선생님#N	1	VHn
ディ先生	 디 선생님#N	1	VHn
カーブホーン先生	 커브혼 선생님#N	1	VHn
かぐや先生	 카구야 선생님#N	1	VHn
あてな先生	 아테나 선생님#N	1	VHn
露伴先生	 로한 선생님#N	1	VHn
大介先生	 다이스케 선생님#N	1	VHn
幌子先生	 호로코 선생님#N	1	VHn
弥栄先生	 야에 선생님#N	1	VHn
蜜子先生	 미츠코 선생님#N	1	VHn
五右衛門先生	 고에몬 선생님#N	1	VHn
虹夢先生	 니지무 선생님#N	1	VHn
御影先生	 미카게 선생님#N	1	VHn
美春先生	 미하루 선생님#N	1	VHn
与吉先生	 요키치 선생님#N	1	VHn
たけし先生	 타케시 선생님#N	1	VHn
まつり先生	 마츠리 선생님#N	1	VHn
プラム先生	 프람 선생님#N	1	VHn
霊元先生	 레이겐 선생님#N	1	VHn
沙雪先生	 사유키 선생님#N	1	VHn
沙取先生	 사토루 선생님#N	1	VHn
征丸先生	 세이마루 선생님#N	1	VHn
つばめ先生	 츠바메 선생님#N	1	VHn
小十郎先生	 코쥬로 선생님#N	1	VHn
良美先生	 요시미 선생님#N	1	VHn
引太郎先生	 히키타로 선생님#N	1	VHn
恭弥先生	 쿄야 선생님#N	1	VHn
アルテ先生	 아테나 선생님#N	1	VHn
ミッドナイト先生	 미드나이트 선생님#N	1	VHn
ミネルバ先生	 미네르바 선생님#N	1	VHn
クラーク先生	 클라크 선생님#N	1	VHn
ミドヴェーチ先生	 미드베치 선생님#N	1	VHn
イェーズ先生	 예즈 선생님#N	1	VHn

有瀬先輩	 아리세 선배#N	1	VHn
石川先輩	 이시카와 선배#N	1	VHn
本郷先輩	 혼고 선배#N	1	VHn
根津先輩	 네즈 선배#N	1	VHn
不破先輩	 후와 선배#N	1	VHn
南句先輩	 난쿠 선배#N	1	VHn
小林先輩	 코바야시 선배#N	1	VHn
明智先輩	 아케치 선배#N	1	VHn
富士先輩	 후지 선배#N	1	VHn
黒鳥先輩	 쿠로토리 선배#N	1	VHn
鳴沢先輩	 나루사와 선배#N	1	VHn
怪盗先輩	 괴도 선배#N	1	VHn
ウィル先輩	 윌 선배#N	1	VHn
シャルロット先輩	 샤를로트 선배#N	1	VHn
カリストー先輩	 칼리스토 선배#N	1	VHn
カリス先輩	 카리스 선배#N	1	VHn
ディ先輩	 디 선배#N	1	VHn
カーブホーン先輩	 커브혼 선배#N	1	VHn
かぐや先輩	 카구야 선배#N	1	VHn
あてな先輩	 아테나 선배#N	1	VHn
露伴先輩	 로한 선배#N	1	VHn
大介先輩	 다이스케 선배#N	1	VHn
幌子先輩	 호로코 선배#N	1	VHn
弥栄先輩	 야에 선배#N	1	VHn
蜜子先輩	 미츠코 선배#N	1	VHn
五右衛門先輩	 고에몬 선배#N	1	VHn
虹夢先輩	 니지무 선배#N	1	VHn
御影先輩	 미카게 선배#N	1	VHn
美春先輩	 미하루 선배#N	1	VHn
与吉先輩	 요키치 선배#N	1	VHn
たけし先輩	 타케시 선배#N	1	VHn
まつり先輩	 마츠리 선배#N	1	VHn
プラム先輩	 프람 선배#N	1	VHn
霊元先輩	 레이겐 선배#N	1	VHn
沙雪先輩	 사유키 선배#N	1	VHn
沙取先輩	 사토루 선배#N	1	VHn
征丸先輩	 세이마루 선배#N	1	VHn
つばめ先輩	 츠바메 선배#N	1	VHn
小十郎先輩	 코쥬로 선배#N	1	VHn
良美先輩	 요시미 선배#N	1	VHn
引太郎先輩	 히키타로 선배#N	1	VHn
恭弥先輩	 쿄야 선배#N	1	VHn
アルテ先輩	 아테나 선배#N	1	VHn
ミッドナイト先輩	 미드나이트 선배#N	1	VHn
ミネルバ先輩	 미네르바 선배#N	1	VHn
クラーク先輩	 클라크 선배#N	1	VHn
ミドヴェーチ先輩	 미드베치 선배#N	1	VHn
イェーズ先輩	 예즈 선배#N	1	VHn

有瀬様が	 아리세님이#N	1	VHn
石川様が	 이시카와님이#N	1	VHn
本郷様が	 혼고님이#N	1	VHn
根津様が	 네즈님이#N	1	VHn
不破様が	 후와님이#N	1	VHn
南句様が	 난쿠님이#N	1	VHn
小林様が	 코바야시님이#N	1	VHn
明智様が	 아케치님이#N	1	VHn
富士様が	 후지님이#N	1	VHn
黒鳥様が	 쿠로토리님이#N	1	VHn
鳴沢様が	 나루사와님이#N	1	VHn
怪盗様が	 괴도님이#N	1	VHn
ウィル様が	 윌님이#N	1	VHn
シャルロット様が	 샤를로트님이#N	1	VHn
カリストー様が	 칼리스토님이#N	1	VHn
カリス様が	 카리스님이#N	1	VHn
ディ様が	 디님이#N	1	VHn
カーブホーン様が	 커브혼님이#N	1	VHn
かぐや様が	 카구야님이#N	1	VHn
あてな様が	 아테나님이#N	1	VHn
露伴様が	 로한님이#N	1	VHn
大介様が	 다이스케님이#N	1	VHn
幌子様が	 호로코님이#N	1	VHn
弥栄様が	 야에님이#N	1	VHn
蜜子様が	 미츠코님이#N	1	VHn
五右衛門様が	 고에몬님이#N	1	VHn
虹夢様が	 니지무님이#N	1	VHn
御影様が	 미카게님이#N	1	VHn
美春様が	 미하루님이#N	1	VHn
与吉様が	 요키치님이#N	1	VHn
たけし様が	 타케시님이#N	1	VHn
まつり様が	 마츠리님이#N	1	VHn
プラム様が	 프람님이#N	1	VHn
霊元様が	 레이겐님이#N	1	VHn
沙雪様が	 사유키님이#N	1	VHn
沙取様が	 사토루님이#N	1	VHn
征丸様が	 세이마루님이#N	1	VHn
つばめ様が	 츠바메님이#N	1	VHn
小十郎様が	 코쥬로님이#N	1	VHn
良美様が	 요시미님이#N	1	VHn
引太郎様が	 히키타로님이#N	1	VHn
恭弥様が	 쿄야님이#N	1	VHn
アルテ様が	 아테나님이#N	1	VHn
ミッドナイト様が	 미드나이트님이#N	1	VHn
ミネルバ様が	 미네르바님이#N	1	VHn
クラーク様が	 클라크님이#N	1	VHn
ミドヴェーチ様が	 미드베치님이#N	1	VHn
イェーズ様が	 예즈님이#N	1	VHn

有瀬君	 아리세군#N	1	VHn
石川君	 이시카와군#N	1	VHn
本郷君	 혼고군#N	1	VHn
根津君	 네즈군#N	1	VHn
不破君	 후와군#N	1	VHn
南句君	 난쿠군#N	1	VHn
小林君	 코바야시군#N	1	VHn
明智君	 아케치군#N	1	VHn
富士君	 후지군#N	1	VHn
黒鳥君	 쿠로토리군#N	1	VHn
鳴沢君	 나루사와군#N	1	VHn
怪盗君	 괴도군#N	1	VHn
ウィル君	 윌군#N	1	VHn
シャルロット君	 샤를로트군#N	1	VHn
カリストー君	 칼리스토군#N	1	VHn
カリス君	 카리스군#N	1	VHn
ディ君	 디군#N	1	VHn
カーブホーン君	 커브혼군#N	1	VHn
かぐや君	 카구야군#N	1	VHn
あてな君	 아테나군#N	1	VHn
露伴君	 로한군#N	1	VHn
大介君	 다이스케군#N	1	VHn
幌子君	 호로코군#N	1	VHn
弥栄君	 야에군#N	1	VHn
蜜子君	 미츠코군#N	1	VHn
五右衛門君	 고에몬군#N	1	VHn
虹夢君	 니지무군#N	1	VHn
御影君	 미카게군#N	1	VHn
美春君	 미하루군#N	1	VHn
与吉君	 요키치군#N	1	VHn
たけし君	 타케시군#N	1	VHn
まつり君	 마츠리군#N	1	VHn
プラム君	 프람군#N	1	VHn
霊元君	 레이겐군#N	1	VHn
沙雪君	 사유키군#N	1	VHn
沙取君	 사토루군#N	1	VHn
征丸君	 세이마루군#N	1	VHn
つばめ君	 츠바메군#N	1	VHn
小十郎君	 코쥬로군#N	1	VHn
良美君	 요시미군#N	1	VHn
引太郎君	 히키타로군#N	1	VHn
恭弥君	 쿄야군#N	1	VHn
アルテ君	 아테나군#N	1	VHn
ミッドナイト君	 미드나이트군#N	1	VHn
ミネルバ君	 미네르바군#N	1	VHn
クラーク君	 클라크군#N	1	VHn
ミドヴェーチ君	 미드베치군#N	1	VHn
イェーズ君	 예즈군#N	1	VHn

有瀬様	 아리세님#N	1	VHn
石川様	 이시카와님#N	1	VHn
本郷様	 혼고님#N	1	VHn
根津様	 네즈님#N	1	VHn
不破様	 후와님#N	1	VHn
南句様	 난쿠님#N	1	VHn
小林様	 코바야시님#N	1	VHn
明智様	 아케치님#N	1	VHn
富士様	 후지님#N	1	VHn
黒鳥様	 쿠로토리님#N	1	VHn
鳴沢様	 나루사와님#N	1	VHn
怪盗様	 괴도님#N	1	VHn
ウィル様	 윌님#N	1	VHn
シャルロット様	 샤를로트님#N	1	VHn
カリストー様	 칼리스토님#N	1	VHn
カリス様	 카리스님#N	1	VHn
ディ様	 디님#N	1	VHn
カーブホーン様	 커브혼님#N	1	VHn
かぐや様	 카구야님#N	1	VHn
あてな様	 아테나님#N	1	VHn
露伴様	 로한님#N	1	VHn
大介様	 다이스케님#N	1	VHn
幌子様	 호로코님#N	1	VHn
弥栄様	 야에님#N	1	VHn
蜜子様	 미츠코님#N	1	VHn
五右衛門様	 고에몬님#N	1	VHn
虹夢様	 니지무님#N	1	VHn
御影様	 미카게님#N	1	VHn
美春様	 미하루님#N	1	VHn
与吉様	 요키치님#N	1	VHn
たけし様	 타케시님#N	1	VHn
まつり様	 마츠리님#N	1	VHn
プラム様	 프람님#N	1	VHn
霊元様	 레이겐님#N	1	VHn
沙雪様	 사유키님#N	1	VHn
沙取様	 사토루님#N	1	VHn
征丸様	 세이마루님#N	1	VHn
つばめ様	 츠바메님#N	1	VHn
小十郎様	 코쥬로님#N	1	VHn
良美様	 요시미님#N	1	VHn
引太郎様	 히키타로님#N	1	VHn
恭弥様	 쿄야님#N	1	VHn
アルテ様	 아테나님#N	1	VHn
ミッドナイト様	 미드나이트님#N	1	VHn
ミネルバ様	 미네르바님#N	1	VHn
クラーク様	 클라크님#N	1	VHn
ミドヴェーチ様	 미드베치님#N	1	VHn
イェーズ様	 예즈님#N	1	VHn

有瀬殿	 아리세공#N	1	VHn
石川殿	 이시카와공#N	1	VHn
本郷殿	 혼고공#N	1	VHn
根津殿	 네즈공#N	1	VHn
不破殿	 후와공#N	1	VHn
南句殿	 난쿠공#N	1	VHn
小林殿	 코바야시공#N	1	VHn
明智殿	 아케치공#N	1	VHn
富士殿	 후지공#N	1	VHn
黒鳥殿	 쿠로토리공#N	1	VHn
鳴沢殿	 나루사와공#N	1	VHn
怪盗殿	 괴도공#N	1	VHn
ウィル殿	 윌공#N	1	VHn
シャルロット殿	 샤를로트공#N	1	VHn
カリストー殿	 칼리스토공#N	1	VHn
カリス殿	 카리스공#N	1	VHn
ディ殿	 디공#N	1	VHn
カーブホーン殿	 커브혼공#N	1	VHn
かぐや殿	 카구야공#N	1	VHn
あてな殿	 아테나공#N	1	VHn
露伴殿	 로한공#N	1	VHn
大介殿	 다이스케공#N	1	VHn
幌子殿	 호로코공#N	1	VHn
弥栄殿	 야에공#N	1	VHn
蜜子殿	 미츠코공#N	1	VHn
五右衛門殿	 고에몬공#N	1	VHn
虹夢殿	 니지무공#N	1	VHn
御影殿	 미카게공#N	1	VHn
美春殿	 미하루공#N	1	VHn
与吉殿	 요키치공#N	1	VHn
たけし殿	 타케시공#N	1	VHn
まつり殿	 마츠리공#N	1	VHn
プラム殿	 프람공#N	1	VHn
霊元殿	 레이겐공#N	1	VHn
沙雪殿	 사유키공#N	1	VHn
沙取殿	 사토루공#N	1	VHn
征丸殿	 세이마루공#N	1	VHn
つばめ殿	 츠바메공#N	1	VHn
小十郎殿	 코쥬로공#N	1	VHn
良美殿	 요시미공#N	1	VHn
引太郎殿	 히키타로공#N	1	VHn
恭弥殿	 쿄야공#N	1	VHn
アルテ殿	 아테나공#N	1	VHn
ミッドナイト殿	 미드나이트공#N	1	VHn
ミネルバ殿	 미네르바공#N	1	VHn
クラーク殿	 클라크공#N	1	VHn
ミドヴェーチ殿	 미드베치공#N	1	VHn
イェーズ殿	 예즈공#N	1	VHn


有瀬	 아리세#N	1	VHn
石川	 이시카와#N	1	VHn
本郷	 혼고#N	1	VHn
根津	 네즈#N	1	VHn
不破	 후와#N	1	VHn
南句	 난쿠#N	1	VHn
小林	 코바야시#N	1	VHn
明智	 아케치#N	1	VHn
富士	 후지#N	1	VHn
黒鳥	 쿠로토리#N	1	VHn
鳴沢	 나루사와#N	1	VHn
怪盗	 괴도#N	1	VHn
ウィル	 윌#N	1	VHn
シャルロット	 샤를로트#N	1	VHn
カリストー	 칼리스토#N	1	VHn
カリス	 카리스#N	1	VHn
ディ	 디#N	1	VHn
カーブホーン	 커브혼#N	1	VHn
かぐや	 카구야#N	1	VHn
あてな	 아테나#N	1	VHn
露伴	 로한#N	1	VHn
大介	 다이스케#N	1	VHn
幌子	 호로코#N	1	VHn
弥栄	 야에#N	1	VHn
蜜子	 미츠코#N	1	VHn
五右衛門	 고에몬#N	1	VHn
虹夢	 니지무#N	1	VHn
御影	 미카게#N	1	VHn
美春	 미하루#N	1	VHn
与吉	 요키치#N	1	VHn
たけし	 타케시#N	1	VHn
まつり	 마츠리#N	1	VHn
プラム	 프람#N	1	VHn
霊元	 레이겐#N	1	VHn
沙雪	 사유키#N	1	VHn
沙取	 사토루#N	1	VHn
征丸	 세이마루#N	1	VHn
つばめ	 츠바메#N	1	VHn
小十郎	 코쥬로#N	1	VHn
良美	 요시미#N	1	VHn
引太郎	 히키타로#N	1	VHn
恭弥	 쿄야#N	1	VHn
アルテ	 아테나#N	1	VHn
ミッドナイト	 미드나이트#N	1	VHn
ミネルバ	 미네르바#N	1	VHn
クラーク	 클라크#N	1	VHn
ミドヴェーチ	 미드베치#N	1	VHn
イェーズ	 예즈#N	1	VHn





//별명
ミカちゃん	 미카짱#N	1	VHn
ミーカち	 미카치#N	1	VHn
ミカち	 미카치#N	1	VHn
にじゅ先輩	 니쥬선배#N	1	VHn
にじゅさん	 니쥬씨#N	1	VHn
にじゅ	 니쥬#N	1	VHn
虹ちゃん	 니지짱#N	1	VHn
にじちゃん	 니지짱#N	1	VHn
ぷーちゃん	 푸우짱#N	1	VHn
はる姉ちゃん	 하루누나#N	1	VHn
ハル姉	 하루누나#N	1	VHn
つばミィ	 츠바밍#N	1	VHn
エビちゃん	 에비짱#N	1	VHn
みっちゃん	 밋짱#N	1	VHn
やん子	 얀코#N	1	VHn
シャルル	 샤르르#N	1	VHn
シャル	 샤르#N	1	VHn
あて姉	 아테언니#N	1	VHn
さとる	 사토루#N	1	VHn
ほろちゃん	 호로짱#N	1	VHn
ナルサワ	 나루사와#N	1	VHn
ハル	 하루#N	1	VHn
ミカ	 미카#N	1	VHn
みすあるて	 미스 아르테#N	1	VHn
さすけ	 사스케#N	1	VHn

//인물명사
時間泥棒	 시간도둑#N	1	VHn
坊主	 꼬맹이#N	1	VHn
百合坂	 유리사카#N	1	VHn
巻貝	 마키가이#N	1	VHn
ええ子	 좋은아이#N	1	VHn


//지명
根津院	 네즈원#M	1	VPl
アイヌ	 아이누#M	1	VPl
大樽	 오오타루#M	1	VPl
沙幌	 사호로#M	1	VPl
ソルティレージュ	 솔티레쥬#M	1	VPl
鹿苑寺	 로쿠온지#M	1	VPl
六菱	 무츠비시#M	1	VPl	//회사명
よかよか	 요카요카#M	1	VPl	//회사명
紅生堂	 코우세이당#M	1	VPl	//회사명
根山	 네야마#M	1	VPl	//회사명

//일반용어
茶碗	 찻잔	1	//밥공기 or 찻잔
ミッション	 Mission	1
ダイヤ	 다이아	1
ヴロフ	 브로프	1
バリツ	 바리츠	1	//셜록홈즈가 익혔다고 알려지는 무술
ルイン	 LINE	1	//루인인데 메신저 LINE 말하는거라 그냥 라인으로 표시
アチチ	 뜨끈뜨끈	1	//사랑의 유행어?로 보임
ペテン	 사기	1
チョコボーロ	 초코보로	1
ラブリッチェ	 러브릿체	1	//ラブリッチェマーク
フェンリルムーン	 Fenrir Moon	1
えちち	 야시시	1



//Ambitious 목록
アンビシャス	 Ambitious	0
シザース	 Scissors	1
レッドラム	 Red Rum	1
ビッグフィッシュ	 Big Fish	1
ザ・プライド	 The Pride	1
ブルズアイ	 Bull's Eye	1
パンズラビリンス	 Pan's Labyrinth	1
デイビィジョーンズ	 Davy Jones	1
ツインヘッド	 Twin Head	1
アレクレピオス	 Aleculapius	1	//아스클레피오스 뜻하는거같은데 작중에선 아레클레피오스로 언급됨