小日向響	 코히나타 히비키#N	1	VHn
鹿島理々	 카시마 리리#N	1	VHn
柊栞里	 히이라기 시오리#N	1	VHn
海堂凪子	 카이도 나기코#N	1	VHn
聖橘花	 히지리 킷카#N	1	VHn
遠野律	 토오노 리츠#N	1	VHn
遠野遊	 토오노 유우#N	1	VHn
鹿島理理	 카시마 리리#N	1	VHn
神楽坂慎二	 카구라자카 신지#N	1	VHn
岬和水	 미사키 나고미#N	1	VHn
山田華子	 야마다 하나코#N	1	VHn
周防真麻	 스오우 마사#N	1	VHn
南篤志	 미나미 아츠시#N	1	VHn
一ノ瀬華恋	 이치노세 카렌#N	1	VHn
井の頭喜久子	 이노가시라 키쿠코#N	1	VHn
六堂橘花	 로쿠도 킷카#N	1	VHn

小日向さん	 코히나타씨#N	1	VHn
鹿島さん	 카시마씨#N	1	VHn
柊さん	 히이라기씨#N	1	VHn
海堂さん	 카이도씨#N	1	VHn
聖さん	 히지리씨#N	1	VHn
遠野さん	 토오노씨#N	1	VHn
神楽坂さん	 카구라자카씨#N	1	VHn
岬さん	 미사키씨#N	1	VHn
山田さん	 야마다씨#N	1	VHn
周防さん	 스오우씨#N	1	VHn
南さん	 미나미씨#N	1	VHn
一ノ瀬さん	 이치노세씨#N	1	VHn
井の頭さん	 이노가시라씨#N	1	VHn
六堂さん	 로쿠도씨#N	1	VHn
凪さん	 나기씨#N	1	VHn
響さん	 히비키씨#N	1	VHn
理々さん	 리리씨#N	1	VHn
栞里さん	 시오리씨#N	1	VHn
凪子さん	 나기코씨#N	1	VHn
橘花さん	 킷카씨#N	1	VHn
律さん	 리츠씨#N	1	VHn
遊さん	 유우씨#N	1	VHn
理理さん	 리리씨#N	1	VHn
慎二さん	 신지씨#N	1	VHn
和水さん	 나고미씨#N	1	VHn
華子さん	 하나코씨#N	1	VHn
真麻さん	 마사씨#N	1	VHn
篤志さん	 아츠시씨#N	1	VHn
華恋さん	 카렌씨#N	1	VHn
喜久子さん	 키쿠코씨#N	1	VHn

小日向ちゃん	 코히나타짱#N	1	VHn
鹿島ちゃん	 카시마짱#N	1	VHn
柊ちゃん	 히이라기짱#N	1	VHn
海堂ちゃん	 카이도짱#N	1	VHn
聖ちゃん	 히지리짱#N	1	VHn
遠野ちゃん	 토오노짱#N	1	VHn
神楽坂ちゃん	 카구라자카짱#N	1	VHn
岬ちゃん	 미사키짱#N	1	VHn
山田ちゃん	 야마다짱#N	1	VHn
周防ちゃん	 스오우짱#N	1	VHn
南ちゃん	 미나미짱#N	1	VHn
一ノ瀬ちゃん	 이치노세짱#N	1	VHn
井の頭ちゃん	 이노가시라짱#N	1	VHn
六堂ちゃん	 로쿠도짱#N	1	VHn
凪ちゃん	 나기짱#N	1	VHn
響ちゃん	 히비키짱#N	1	VHn
理々ちゃん	 리리짱#N	1	VHn
栞里ちゃん	 시오리짱#N	1	VHn
凪子ちゃん	 나기코짱#N	1	VHn
橘花ちゃん	 킷카짱#N	1	VHn
律ちゃん	 리츠짱#N	1	VHn
遊ちゃん	 유우짱#N	1	VHn
理理ちゃん	 리리짱#N	1	VHn
慎二ちゃん	 신지짱#N	1	VHn
和水ちゃん	 나고미짱#N	1	VHn
華子ちゃん	 하나코짱#N	1	VHn
真麻ちゃん	 마사짱#N	1	VHn
篤志ちゃん	 아츠시짱#N	1	VHn
華恋ちゃん	 카렌짱#N	1	VHn
喜久子ちゃん	 키쿠코짱#N	1	VHn

小日向くぅん	 코히나타군~#N	1	VHn
鹿島くぅん	 카시마군~#N	1	VHn
柊くぅん	 히이라기군~#N	1	VHn
海堂くぅん	 카이도군~#N	1	VHn
聖くぅん	 히지리군~#N	1	VHn
遠野くぅん	 토오노군~#N	1	VHn
神楽坂くぅん	 카구라자카군~#N	1	VHn
岬くぅん	 미사키군~#N	1	VHn
山田くぅん	 야마다군~#N	1	VHn
周防くぅん	 스오우군~#N	1	VHn
南くぅん	 미나미군~#N	1	VHn
一ノ瀬くぅん	 이치노세군~#N	1	VHn
井の頭くぅん	 이노가시라군~#N	1	VHn
六堂くぅん	 로쿠도군~#N	1	VHn
凪くぅん	 나기군~#N	1	VHn
響くぅん	 히비키군~#N	1	VHn
理々くぅん	 리리군~#N	1	VHn
栞里くぅん	 시오리군~#N	1	VHn
凪子くぅん	 나기코군~#N	1	VHn
橘花くぅん	 킷카군~#N	1	VHn
律くぅん	 리츠군~#N	1	VHn
遊くぅん	 유우군~#N	1	VHn
理理くぅん	 리리군~#N	1	VHn
慎二くぅん	 신지군~#N	1	VHn
和水くぅん	 나고미군~#N	1	VHn
華子くぅん	 하나코군~#N	1	VHn
真麻くぅん	 마사군~#N	1	VHn
篤志くぅん	 아츠시군~#N	1	VHn
華恋くぅん	 카렌군~#N	1	VHn
喜久子くぅん	 키쿠코군~#N	1	VHn

小日向ちん	 코히나타찡#N	1	VHn
鹿島ちん	 카시마찡#N	1	VHn
柊ちん	 히이라기찡#N	1	VHn
海堂ちん	 카이도찡#N	1	VHn
聖ちん	 히지리찡#N	1	VHn
遠野ちん	 토오노찡#N	1	VHn
神楽坂ちん	 카구라자카찡#N	1	VHn
岬ちん	 미사키찡#N	1	VHn
山田ちん	 야마다찡#N	1	VHn
周防ちん	 스오우찡#N	1	VHn
南ちん	 미나미찡#N	1	VHn
一ノ瀬ちん	 이치노세찡#N	1	VHn
井の頭ちん	 이노가시라찡#N	1	VHn
六堂ちん	 로쿠도찡#N	1	VHn
凪ちん	 나기찡#N	1	VHn
響ちん	 히비키찡#N	1	VHn
理々ちん	 리리찡#N	1	VHn
栞里ちん	 시오리찡#N	1	VHn
凪子ちん	 나기코찡#N	1	VHn
橘花ちん	 킷카찡#N	1	VHn
律ちん	 리츠찡#N	1	VHn
遊ちん	 유우찡#N	1	VHn
理理ちん	 리리찡#N	1	VHn
慎二ちん	 신지찡#N	1	VHn
和水ちん	 나고미찡#N	1	VHn
華子ちん	 하나코찡#N	1	VHn
真麻ちん	 마사찡#N	1	VHn
篤志ちん	 아츠시찡#N	1	VHn
華恋ちん	 카렌찡#N	1	VHn
喜久子ちん	 키쿠코찡#N	1	VHn

小日向くん	 코히나타군#N	1	VHn
鹿島くん	 카시마군#N	1	VHn
柊くん	 히이라기군#N	1	VHn
海堂くん	 카이도군#N	1	VHn
聖くん	 히지리군#N	1	VHn
遠野くん	 토오노군#N	1	VHn
神楽坂くん	 카구라자카군#N	1	VHn
岬くん	 미사키군#N	1	VHn
山田くん	 야마다군#N	1	VHn
周防くん	 스오우군#N	1	VHn
南くん	 미나미군#N	1	VHn
一ノ瀬くん	 이치노세군#N	1	VHn
井の頭くん	 이노가시라군#N	1	VHn
六堂くん	 로쿠도군#N	1	VHn
凪くん	 나기군#N	1	VHn
響くん	 히비키군#N	1	VHn
理々くん	 리리군#N	1	VHn
栞里くん	 시오리군#N	1	VHn
凪子くん	 나기코군#N	1	VHn
橘花くん	 킷카군#N	1	VHn
律くん	 리츠군#N	1	VHn
遊くん	 유우군#N	1	VHn
理理くん	 리리군#N	1	VHn
慎二くん	 신지군#N	1	VHn
和水くん	 나고미군#N	1	VHn
華子くん	 하나코군#N	1	VHn
真麻くん	 마사군#N	1	VHn
篤志くん	 아츠시군#N	1	VHn
華恋くん	 카렌군#N	1	VHn
喜久子くん	 키쿠코군#N	1	VHn

小日向たん	 코히나타땅#N	1	VHn
鹿島たん	 카시마땅#N	1	VHn
柊たん	 히이라기땅#N	1	VHn
海堂たん	 카이도땅#N	1	VHn
聖たん	 히지리땅#N	1	VHn
遠野たん	 토오노땅#N	1	VHn
神楽坂たん	 카구라자카땅#N	1	VHn
岬たん	 미사키땅#N	1	VHn
山田たん	 야마다땅#N	1	VHn
周防たん	 스오우땅#N	1	VHn
南たん	 미나미땅#N	1	VHn
一ノ瀬たん	 이치노세땅#N	1	VHn
井の頭たん	 이노가시라땅#N	1	VHn
六堂たん	 로쿠도땅#N	1	VHn
凪たん	 나기땅#N	1	VHn
響たん	 히비키땅#N	1	VHn
理々たん	 리리땅#N	1	VHn
栞里たん	 시오리땅#N	1	VHn
凪子たん	 나기코땅#N	1	VHn
橘花たん	 킷카땅#N	1	VHn
律たん	 리츠땅#N	1	VHn
遊たん	 유우땅#N	1	VHn
理理たん	 리리땅#N	1	VHn
慎二たん	 신지땅#N	1	VHn
和水たん	 나고미땅#N	1	VHn
華子たん	 하나코땅#N	1	VHn
真麻たん	 마사땅#N	1	VHn
篤志たん	 아츠시땅#N	1	VHn
華恋たん	 카렌땅#N	1	VHn
喜久子たん	 키쿠코땅#N	1	VHn

小日向っち	 코히나타치#N	1	VHn
鹿島っち	 카시마치#N	1	VHn
柊っち	 히이라기치#N	1	VHn
海堂っち	 카이도치#N	1	VHn
聖っち	 히지리치#N	1	VHn
遠野っち	 토오노치#N	1	VHn
神楽坂っち	 카구라자카치#N	1	VHn
岬っち	 미사키치#N	1	VHn
山田っち	 야마다치#N	1	VHn
周防っち	 스오우치#N	1	VHn
南っち	 미나미치#N	1	VHn
一ノ瀬っち	 이치노세치#N	1	VHn
井の頭っち	 이노가시라치#N	1	VHn
六堂っち	 로쿠도치#N	1	VHn
凪っち	 나기치#N	1	VHn
響っち	 히비키치#N	1	VHn
理々っち	 리리치#N	1	VHn
栞里っち	 시오리치#N	1	VHn
凪子っち	 나기코치#N	1	VHn
橘花っち	 킷카치#N	1	VHn
律っち	 리츠치#N	1	VHn
遊っち	 유우치#N	1	VHn
理理っち	 리리치#N	1	VHn
慎二っち	 신지치#N	1	VHn
和水っち	 나고미치#N	1	VHn
華子っち	 하나코치#N	1	VHn
真麻っち	 마사치#N	1	VHn
篤志っち	 아츠시치#N	1	VHn
華恋っち	 카렌치#N	1	VHn
喜久子っち	 키쿠코치#N	1	VHn

小日向手作り	 코히나타 수제#N	1	VHn
鹿島手作り	 카시마 수제#N	1	VHn
柊手作り	 히이라기 수제#N	1	VHn
海堂手作り	 카이도 수제#N	1	VHn
聖手作り	 히지리 수제#N	1	VHn
遠野手作り	 토오노 수제#N	1	VHn
神楽坂手作り	 카구라자카 수제#N	1	VHn
岬手作り	 미사키 수제#N	1	VHn
山田手作り	 야마다 수제#N	1	VHn
周防手作り	 스오우 수제#N	1	VHn
南手作り	 미나미 수제#N	1	VHn
一ノ瀬手作り	 이치노세 수제#N	1	VHn
井の頭手作り	 이노가시라 수제#N	1	VHn
六堂手作り	 로쿠도 수제#N	1	VHn
凪手作り	 나기 수제#N	1	VHn
響手作り	 히비키 수제#N	1	VHn
理々手作り	 리리 수제#N	1	VHn
栞里手作り	 시오리 수제#N	1	VHn
凪子手作り	 나기코 수제#N	1	VHn
橘花手作り	 킷카 수제#N	1	VHn
律手作り	 리츠 수제#N	1	VHn
遊手作り	 유우 수제#N	1	VHn
理理手作り	 리리 수제#N	1	VHn
慎二手作り	 신지 수제#N	1	VHn
和水手作り	 나고미 수제#N	1	VHn
華子手作り	 하나코 수제#N	1	VHn
真麻手作り	 마사 수제#N	1	VHn
篤志手作り	 아츠시 수제#N	1	VHn
華恋手作り	 카렌 수제#N	1	VHn
喜久子手作り	 키쿠코 수제#N	1	VHn

小日向先生	 코히나타 선생님#N	1	VHn
鹿島先生	 카시마 선생님#N	1	VHn
柊先生	 히이라기 선생님#N	1	VHn
海堂先生	 카이도 선생님#N	1	VHn
聖先生	 히지리 선생님#N	1	VHn
遠野先生	 토오노 선생님#N	1	VHn
神楽坂先生	 카구라자카 선생님#N	1	VHn
岬先生	 미사키 선생님#N	1	VHn
山田先生	 야마다 선생님#N	1	VHn
周防先生	 스오우 선생님#N	1	VHn
南先生	 미나미 선생님#N	1	VHn
一ノ瀬先生	 이치노세 선생님#N	1	VHn
井の頭先生	 이노가시라 선생님#N	1	VHn
六堂先生	 로쿠도 선생님#N	1	VHn
凪先生	 나기 선생님#N	1	VHn
響先生	 히비키 선생님#N	1	VHn
理々先生	 리리 선생님#N	1	VHn
栞里先生	 시오리 선생님#N	1	VHn
凪子先生	 나기코 선생님#N	1	VHn
橘花先生	 킷카 선생님#N	1	VHn
律先生	 리츠 선생님#N	1	VHn
遊先生	 유우 선생님#N	1	VHn
理理先生	 리리 선생님#N	1	VHn
慎二先生	 신지 선생님#N	1	VHn
和水先生	 나고미 선생님#N	1	VHn
華子先生	 하나코 선생님#N	1	VHn
真麻先生	 마사 선생님#N	1	VHn
篤志先生	 아츠시 선생님#N	1	VHn
華恋先生	 카렌 선생님#N	1	VHn
喜久子先生	 키쿠코 선생님#N	1	VHn

小日向先輩	 코히나타 선배#N	1	VHn
鹿島先輩	 카시마 선배#N	1	VHn
柊先輩	 히이라기 선배#N	1	VHn
海堂先輩	 카이도 선배#N	1	VHn
聖先輩	 히지리 선배#N	1	VHn
遠野先輩	 토오노 선배#N	1	VHn
神楽坂先輩	 카구라자카 선배#N	1	VHn
岬先輩	 미사키 선배#N	1	VHn
山田先輩	 야마다 선배#N	1	VHn
周防先輩	 스오우 선배#N	1	VHn
南先輩	 미나미 선배#N	1	VHn
一ノ瀬先輩	 이치노세 선배#N	1	VHn
井の頭先輩	 이노가시라 선배#N	1	VHn
六堂先輩	 로쿠도 선배#N	1	VHn
凪先輩	 나기 선배#N	1	VHn
響先輩	 히비키 선배#N	1	VHn
理々先輩	 리리 선배#N	1	VHn
栞里先輩	 시오리 선배#N	1	VHn
凪子先輩	 나기코 선배#N	1	VHn
橘花先輩	 킷카 선배#N	1	VHn
律先輩	 리츠 선배#N	1	VHn
遊先輩	 유우 선배#N	1	VHn
理理先輩	 리리 선배#N	1	VHn
慎二先輩	 신지 선배#N	1	VHn
和水先輩	 나고미 선배#N	1	VHn
華子先輩	 하나코 선배#N	1	VHn
真麻先輩	 마사 선배#N	1	VHn
篤志先輩	 아츠시 선배#N	1	VHn
華恋先輩	 카렌 선배#N	1	VHn
喜久子先輩	 키쿠코 선배#N	1	VHn

小日向様が	 코히나타님이#N	1	VHn
鹿島様が	 카시마님이#N	1	VHn
柊様が	 히이라기님이#N	1	VHn
海堂様が	 카이도님이#N	1	VHn
聖様が	 히지리님이#N	1	VHn
遠野様が	 토오노님이#N	1	VHn
神楽坂様が	 카구라자카님이#N	1	VHn
岬様が	 미사키님이#N	1	VHn
山田様が	 야마다님이#N	1	VHn
周防様が	 스오우님이#N	1	VHn
南様が	 미나미님이#N	1	VHn
一ノ瀬様が	 이치노세님이#N	1	VHn
井の頭様が	 이노가시라님이#N	1	VHn
六堂様が	 로쿠도님이#N	1	VHn
凪様が	 나기님이#N	1	VHn
響様が	 히비키님이#N	1	VHn
理々様が	 리리님이#N	1	VHn
栞里様が	 시오리님이#N	1	VHn
凪子様が	 나기코님이#N	1	VHn
橘花様が	 킷카님이#N	1	VHn
律様が	 리츠님이#N	1	VHn
遊様が	 유우님이#N	1	VHn
理理様が	 리리님이#N	1	VHn
慎二様が	 신지님이#N	1	VHn
和水様が	 나고미님이#N	1	VHn
華子様が	 하나코님이#N	1	VHn
真麻様が	 마사님이#N	1	VHn
篤志様が	 아츠시님이#N	1	VHn
華恋様が	 카렌님이#N	1	VHn
喜久子様が	 키쿠코님이#N	1	VHn

小日向君	 코히나타군#N	1	VHn
鹿島君	 카시마군#N	1	VHn
柊君	 히이라기군#N	1	VHn
海堂君	 카이도군#N	1	VHn
聖君	 히지리군#N	1	VHn
遠野君	 토오노군#N	1	VHn
神楽坂君	 카구라자카군#N	1	VHn
岬君	 미사키군#N	1	VHn
山田君	 야마다군#N	1	VHn
周防君	 스오우군#N	1	VHn
南君	 미나미군#N	1	VHn
一ノ瀬君	 이치노세군#N	1	VHn
井の頭君	 이노가시라군#N	1	VHn
六堂君	 로쿠도군#N	1	VHn
凪君	 나기군#N	1	VHn
響君	 히비키군#N	1	VHn
理々君	 리리군#N	1	VHn
栞里君	 시오리군#N	1	VHn
凪子君	 나기코군#N	1	VHn
橘花君	 킷카군#N	1	VHn
律君	 리츠군#N	1	VHn
遊君	 유우군#N	1	VHn
理理君	 리리군#N	1	VHn
慎二君	 신지군#N	1	VHn
和水君	 나고미군#N	1	VHn
華子君	 하나코군#N	1	VHn
真麻君	 마사군#N	1	VHn
篤志君	 아츠시군#N	1	VHn
華恋君	 카렌군#N	1	VHn
喜久子君	 키쿠코군#N	1	VHn

小日向様	 코히나타님#N	1	VHn
鹿島様	 카시마님#N	1	VHn
柊様	 히이라기님#N	1	VHn
海堂様	 카이도님#N	1	VHn
聖様	 히지리님#N	1	VHn
遠野様	 토오노님#N	1	VHn
神楽坂様	 카구라자카님#N	1	VHn
岬様	 미사키님#N	1	VHn
山田様	 야마다님#N	1	VHn
周防様	 스오우님#N	1	VHn
南様	 미나미님#N	1	VHn
一ノ瀬様	 이치노세님#N	1	VHn
井の頭様	 이노가시라님#N	1	VHn
六堂様	 로쿠도님#N	1	VHn
凪様	 나기님#N	1	VHn
響様	 히비키님#N	1	VHn
理々様	 리리님#N	1	VHn
栞里様	 시오리님#N	1	VHn
凪子様	 나기코님#N	1	VHn
橘花様	 킷카님#N	1	VHn
律様	 리츠님#N	1	VHn
遊様	 유우님#N	1	VHn
理理様	 리리님#N	1	VHn
慎二様	 신지님#N	1	VHn
和水様	 나고미님#N	1	VHn
華子様	 하나코님#N	1	VHn
真麻様	 마사님#N	1	VHn
篤志様	 아츠시님#N	1	VHn
華恋様	 카렌님#N	1	VHn
喜久子様	 키쿠코님#N	1	VHn

小日向殿	 코히나타공#N	1	VHn
鹿島殿	 카시마공#N	1	VHn
柊殿	 히이라기공#N	1	VHn
海堂殿	 카이도공#N	1	VHn
聖殿	 히지리공#N	1	VHn
遠野殿	 토오노공#N	1	VHn
神楽坂殿	 카구라자카공#N	1	VHn
岬殿	 미사키공#N	1	VHn
山田殿	 야마다공#N	1	VHn
周防殿	 스오우공#N	1	VHn
南殿	 미나미공#N	1	VHn
一ノ瀬殿	 이치노세공#N	1	VHn
井の頭殿	 이노가시라공#N	1	VHn
六堂殿	 로쿠도공#N	1	VHn
凪殿	 나기공#N	1	VHn
響殿	 히비키공#N	1	VHn
理々殿	 리리공#N	1	VHn
栞里殿	 시오리공#N	1	VHn
凪子殿	 나기코공#N	1	VHn
橘花殿	 킷카공#N	1	VHn
律殿	 리츠공#N	1	VHn
遊殿	 유우공#N	1	VHn
理理殿	 리리공#N	1	VHn
慎二殿	 신지공#N	1	VHn
和水殿	 나고미공#N	1	VHn
華子殿	 하나코공#N	1	VHn
真麻殿	 마사공#N	1	VHn
篤志殿	 아츠시공#N	1	VHn
華恋殿	 카렌공#N	1	VHn
喜久子殿	 키쿠코공#N	1	VHn


小日向	 코히나타#N	1	VHn
鹿島	 카시마#N	1	VHn
海堂	 카이도#N	1	VHn
遠野	 토오노#N	1	VHn
神楽坂	 카구라자카#N	1	VHn
山田	 야마다#N	1	VHn
周防	 스오우#N	1	VHn
一ノ瀬	 이치노세#N	1	VHn
井の頭	 이노가시라#N	1	VHn
六堂	 로쿠도#N	1	VHn
理々	 리리#N	1	VHn
栞里	 시오리#N	1	VHn
凪子	 나기코#N	1	VHn
橘花	 킷카#N	1	VHn
理理	 리리#N	1	VHn
慎二	 신지#N	1	VHn
和水	 나고미#N	1	VHn
華子	 하나코#N	1	VHn
真麻	 마사#N	1	VHn
篤志	 아츠시#N	1	VHn
華恋	 카렌#N	1	VHn
喜久子	 키쿠코#N	1	VHn

岬遊	 미사키 유우#N	1	VHn
シオリン	 시오린#N	1	VHn
コタロー	 코타로#N	1	VHn
りっちゃん	 릿짱#N	1	VHn
遊実さん	 유미씨#N	1	VHn
遊実	 유미#N	1	VHn
遊美	 유미#N	1	VHn	//주인공의 친모
権蔵	 곤조#N	1	VHn	//나기코의 부친
たっくん	 탓군#N	1	VHn

カグヨルナコ	 카구요 루나코	1
キズナマイ	 키즈나 마이	1
バーチャルヨーチューバー	 버츄얼 유튜버	1
ヨーチューバー	 유튜버	1
ヨーチューブ	 유튜브	1
ビビりちゃんねる	 비비리 채널	1
ネットフラックス	 넷플릭스	1
ネガティ部	 네거티부	1
アクティ部	 액티부	1
キャッサバ	 카사바	1
ドーテー	 동정	1
セーシュン	 청춘	1
こいつ	 이 녀석	1
青春スパーキン	 청춘 스파킹	1

岬家	 미사키가#M	1	VPl
玉浦神社	 타마우라 신사#M	1	VPl
玉浦	 타마우라#M	1	VPl
風見学園	 카자미 학원#M	1	VPl
風見	 카자미#M	1	VPl
配信用	 방송용#M	1	VPl
配信	 방송#M	1	VPl